Roll,Maths,Physics,Chemistry,Total,Percentage
1,55,45,56,156,52.00
2,75,55,55,185,61.67
3,25,54,89,168,56.00
4,78,55,86,219,73.00
5,58,96,78,232,77.33
6,88,78,58,224,74.67
7,56,89,69,214,71.33
8,54,55,88,197,65.67
9,46,66,65,177,59.00
10,89,87,54,230,76.67
